15 15 100
# #############
 %          *##
#      F  ### #
#      + -D*   
#      $  #####
#             #
#   #######   #
#         #   #
#        ######
#             #
#             #
#             #
#             #
# ^           #
###############
